1:
#####################
................#...#
###########.###.#.#.#
#...#.......#.#...#.#
#.#.#.#######.#####.#
#.#..$#.#.$....$....#
#.#####.#.#######.###
#.#.......#.....#.#.#
#.#########.###.#.#.#
#.#...........#.#...#
#.#.#$####$.###$###.#
#...#.....#.#...#...#
#.###.###.###.#.#.###
#...#.#.....#.#.#...#
#####################
#.#.#$..#.$...#$..#.#
#.#.###.###.#.#.###.#
#...#...#...#.....#.#
#.###.###.#.#####.#.#
#...#.....#..........
#####################

2:
#####################
#.........#.........#
#.###.###.#########.#
#.......#...........#
#######.###########.#
#....$#...$....$....#
#.###.#####.#######.#
#.#.........#.......#
#.#####.#.#.#.#####.#
#...#...#.#.#.#...#.#
###.#$###.$.#.#$#.#.#
#...#.#.#.#...#.#.#.#
#.#.#.#.#.###.#.#.#.#
#.#.....#.........#.#
#.#####.###.#####.#.#
#....$#...$.#..$..#.#
#.###.#.###.#.#####.#
#...#...#.....#.....#
###.#####.#####.#####
#.......#...........#
#####################